{
	"tiles": "outdoors",
         "data":[7, 8, 7, 8, 7, 8, 7, 8, 7, 8, 7, 8, 7, 8, 7, 8, 7, 8, 7, 8, 7, 8, 7, 8, 7, 8, 7, 8, 7, 8, 7, 8, 7, 8, 7, 8, 7, 8, 7, 8, 7, 8, 7, 8, 7, 8, 7, 8, 7, 8, 7, 8, 7, 8, 7, 8, 7, 8, 7, 8,
            9, 10, 9, 10, 9, 10, 9, 10, 9, 10, 9, 10, 9, 10, 9, 10, 9, 10, 9, 10, 9, 10, 9, 10, 9, 10, 9, 10, 9, 10, 9, 10, 9, 10, 9, 10, 9, 10, 9, 10, 9, 10, 9, 10, 9, 10, 9, 10, 9, 10, 9, 10, 9, 10, 9, 10, 9, 10, 9, 10,
            7, 8, 7, 8, 7, 8, 4, 4, 4, 4, 4, 4, 4, 4, 4, 4, 4, 4, 4, 4, 4, 4, 4, 4, 4, 4, 4, 4, 7, 8, 7, 8, 7, 8, 7, 8, 7, 8, 7, 8, 7, 8, 7, 8, 7, 8, 7, 8, 7, 8, 7, 8, 7, 8, 7, 8, 7, 8, 7, 8,
            9, 10, 9, 10, 9, 10, 4, 4, 4, 4, 4, 4, 4, 4, 4, 4, 4, 4, 4, 2, 2, 2, 2, 2, 2, 3, 2, 4, 9, 10, 9, 10, 9, 10, 9, 10, 9, 10, 9, 10, 9, 10, 9, 10, 9, 10, 9, 10, 9, 10, 9, 10, 9, 10, 9, 10, 9, 10, 9, 10,
            7, 8, 7, 8, 7, 8, 4, 4, 2, 5, 2, 2, 2, 2, 2, 2, 3, 2, 2, 2, 2, 11, 12, 13, 2, 2, 2, 4, 7, 8, 7, 8, 7, 8, 7, 8, 7, 8, 7, 8, 7, 8, 7, 8, 7, 8, 7, 8, 7, 8, 7, 8, 7, 8, 7, 8, 7, 8, 7, 8,
            9, 10, 9, 10, 9, 10, 4, 4, 2, 2, 2, 2, 2, 2, 7, 8, 2, 2, 2, 2, 2, 14, 15, 16, 2, 2, 2, 4, 9, 10, 9, 10, 9, 10, 9, 10, 9, 10, 9, 10, 9, 10, 9, 10, 9, 10, 9, 10, 9, 10, 9, 10, 9, 10, 9, 10, 9, 10, 9, 10,
            7, 8, 7, 8, 7, 8, 4, 4, 2, 2, 11, 12, 13, 2, 9, 10, 2, 2, 3, 2, 2, 17, 18, 19, 2, 2, 2, 4, 7, 8, 7, 8, 7, 8, 7, 8, 7, 8, 7, 8, 7, 8, 7, 8, 7, 8, 7, 8, 7, 8, 7, 8, 7, 8, 7, 8, 7, 8, 7, 8,
            9, 10, 9, 10, 9, 10, 4, 4, 3, 2, 14, 15, 16, 2, 2, 2, 2, 2, 2, 2, 2, 2, 2, 2, 2, 3, 2, 4, 9, 10, 9, 10, 9, 10, 9, 10, 9, 10, 9, 10, 9, 10, 9, 10, 9, 10, 9, 10, 9, 10, 9, 10, 9, 10, 9, 10, 9, 10, 9, 10,
            7, 8, 7, 8, 7, 8, 4, 4, 2, 2, 17, 18, 19, 2, 2, 2, 5, 2, 2, 2, 2, 2, 2, 2, 2, 2, 4, 4, 7, 8, 7, 8, 7, 8, 7, 8, 7, 8, 7, 8, 7, 8, 7, 8, 7, 8, 7, 8, 7, 8, 7, 8, 7, 8, 7, 8, 7, 8, 7, 8,
            9, 10, 9, 10, 9, 10, 4, 4, 2, 3, 2, 2, 2, 2, 3, 2, 2, 2, 2, 2, 3, 2, 5, 5, 5, 5, 4, 4, 9, 10, 9, 10, 9, 10, 9, 10, 9, 10, 9, 10, 9, 10, 9, 10, 9, 10, 9, 10, 9, 10, 9, 10, 9, 10, 9, 10, 9, 10, 9, 10,
            7, 8, 7, 8, 7, 8, 4, 4, 2, 2, 2, 2, 2, 2, 2, 2, 2, 2, 2, 2, 2, 2, 5, 5, 5, 5, 4, 4, 7, 8, 7, 8, 7, 8, 20, 20, 20, 20, 20, 20, 7, 8, 7, 8, 7, 8, 7, 8, 7, 8, 7, 8, 7, 8, 7, 8, 7, 8, 7, 8,
            9, 10, 9, 10, 9, 10, 4, 4, 5, 5, 5, 2, 2, 2, 2, 11, 12, 22, 23, 2, 2, 2, 5, 5, 5, 4, 4, 4, 9, 10, 9, 10, 20, 20, 20, 20, 20, 20, 20, 20, 9, 10, 9, 10, 9, 10, 9, 10, 9, 10, 9, 10, 9, 10, 9, 10, 9, 10, 9, 10,
            7, 8, 7, 8, 7, 8, 4, 4, 5, 5, 5, 2, 5, 2, 2, 14, 24, 25, 16, 2, 2, 2, 2, 2, 2, 20, 20, 20, 20, 20, 20, 20, 20, 20, 20, 20, 20, 20, 20, 20, 7, 8, 7, 8, 7, 8, 7, 8, 7, 8, 7, 8, 7, 8, 7, 8, 7, 8, 7, 8,
            9, 10, 9, 10, 9, 10, 4, 2, 5, 5, 5, 2, 2, 2, 2, 17, 26, 27, 19, 2, 2, 3, 2, 2, 2, 20, 20, 20, 20, 20, 20, 20, 20, 20, 20, 20, 20, 20, 20, 20, 9, 10, 9, 10, 9, 10, 9, 10, 9, 10, 9, 10, 9, 10, 9, 10, 9, 10, 9, 10,
            7, 8, 7, 8, 7, 8, 4, 2, 5, 5, 5, 5, 2, 2, 2, 2, 2, 2, 2, 2, 2, 2, 2, 2, 2, 20, 20, 20, 20, 20, 20, 20, 20, 20, 20, 20, 20, 20, 20, 20, 7, 8, 7, 8, 7, 8, 7, 8, 7, 8, 7, 8, 7, 8, 7, 8, 7, 8, 7, 8,
            9, 10, 9, 10, 9, 10, 4, 2, 5, 5, 5, 5, 2, 3, 2, 2, 2, 2, 2, 2, 5, 5, 2, 2, 3, 20, 20, 20, 20, 20, 20, 20, 20, 20, 20, 20, 20, 20, 20, 20, 9, 10, 9, 10, 9, 10, 9, 10, 9, 10, 9, 10, 9, 10, 9, 10, 9, 10, 9, 10,
            7, 8, 7, 8, 7, 8, 4, 2, 2, 5, 5, 5, 2, 2, 2, 2, 2, 2, 2, 2, 5, 5, 2, 2, 3, 3, 4, 4, 7, 8, 7, 8, 7, 20, 20, 20, 20, 20, 20, 20, 7, 8, 7, 8, 7, 8, 7, 8, 7, 8, 7, 8, 7, 8, 7, 8, 7, 8, 7, 8,
            9, 10, 9, 10, 9, 10, 2, 2, 2, 2, 2, 2, 2, 2, 2, 2, 2, 2, 2, 2, 2, 2, 2, 2, 2, 2, 4, 4, 9, 10, 9, 10, 9, 10, 9, 20, 20, 20, 20, 20, 9, 10, 9, 10, 9, 10, 9, 10, 9, 10, 9, 10, 9, 10, 9, 10, 9, 10, 9, 10,
            7, 8, 7, 8, 7, 8, 7, 8, 7, 8, 7, 8, 5, 5, 5, 5, 7, 8, 7, 8, 7, 8, 7, 8, 7, 8, 7, 8, 7, 8, 7, 8, 7, 8, 7, 8, 7, 8, 7, 8, 7, 8, 7, 8, 7, 8, 7, 8, 7, 8, 7, 8, 7, 8, 7, 8, 7, 8, 7, 8,
            9, 10, 9, 10, 9, 10, 9, 10, 9, 10, 9, 10, 5, 5, 5, 5, 9, 10, 9, 10, 9, 10, 9, 10, 9, 10, 9, 10, 9, 10, 9, 10, 9, 10, 9, 10, 9, 10, 9, 10, 9, 10, 9, 10, 9, 10, 9, 10, 9, 10, 9, 10, 9, 10, 9, 10, 9, 10, 9, 10,
            7, 8, 7, 8, 7, 8, 7, 8, 7, 8, 2, 2, 5, 5, 5, 2, 7, 8, 7, 8, 7, 8, 7, 8, 7, 8, 7, 8, 7, 8, 7, 8, 7, 8, 7, 8, 7, 8, 7, 8, 7, 8, 7, 8, 7, 8, 7, 8, 7, 8, 7, 8, 7, 8, 7, 8, 7, 8, 7, 8,
            9, 10, 9, 10, 9, 10, 9, 10, 9, 10, 2, 2, 2, 2, 2, 2, 9, 10, 9, 10, 9, 10, 9, 10, 9, 10, 9, 10, 9, 10, 9, 10, 9, 10, 9, 10, 9, 10, 9, 10, 9, 10, 9, 10, 9, 10, 9, 10, 9, 10, 9, 10, 9, 10, 9, 10, 9, 10, 9, 10,
            7, 8, 7, 8, 7, 8, 7, 8, 2, 2, 2, 3, 2, 2, 2, 2, 7, 8, 7, 8, 7, 8, 7, 8, 7, 8, 7, 8, 7, 8, 7, 8, 7, 8, 7, 8, 7, 8, 7, 8, 7, 8, 7, 8, 7, 8, 7, 8, 7, 8, 7, 8, 7, 8, 7, 8, 7, 8, 7, 8,
            9, 10, 9, 10, 9, 10, 9, 10, 2, 2, 2, 2, 2, 2, 7, 8, 9, 10, 9, 10, 9, 10, 9, 10, 9, 10, 9, 10, 9, 10, 9, 10, 9, 10, 9, 10, 9, 10, 9, 10, 9, 10, 9, 10, 9, 10, 9, 10, 9, 10, 9, 10, 9, 10, 9, 10, 9, 10, 9, 10,
            7, 8, 7, 8, 7, 8, 7, 8, 7, 8, 2, 2, 2, 3, 9, 10, 2, 2, 2, 2, 4, 2, 2, 2, 3, 2, 5, 2, 7, 8, 7, 8, 7, 8, 7, 8, 7, 8, 7, 8, 7, 8, 7, 8, 7, 8, 7, 8, 7, 8, 7, 8, 7, 8, 7, 8, 7, 8, 7, 8,
            9, 10, 9, 10, 9, 10, 9, 10, 9, 10, 2, 2, 2, 2, 7, 8, 2, 2, 4, 2, 2, 2, 4, 2, 2, 5, 6, 5, 9, 10, 9, 10, 9, 10, 9, 10, 9, 10, 9, 10, 9, 10, 9, 10, 9, 10, 9, 10, 9, 10, 9, 10, 9, 10, 9, 10, 9, 10, 9, 10,
            7, 8, 7, 8, 7, 8, 7, 8, 6, 6, 5, 2, 2, 2, 9, 10, 2, 2, 7, 8, 7, 8, 7, 8, 5, 5, 6, 6, 7, 8, 7, 8, 7, 8, 7, 8, 7, 8, 7, 8, 7, 8, 7, 8, 7, 8, 7, 8, 7, 8, 7, 8, 7, 8, 7, 8, 7, 8, 7, 8,
            9, 10, 9, 10, 9, 10, 9, 10, 6, 6, 5, 2, 2, 7, 8, 2, 2, 2, 9, 10, 9, 10, 9, 10, 5, 6, 6, 6, 9, 10, 9, 10, 9, 10, 9, 10, 9, 10, 9, 10, 9, 10, 9, 10, 9, 10, 9, 10, 9, 10, 9, 10, 9, 10, 9, 10, 9, 10, 9, 10,
            7, 8, 7, 8, 7, 8, 6, 6, 6, 6, 5, 2, 2, 9, 10, 2, 2, 2, 7, 8, 7, 8, 7, 8, 6, 6, 6, 6, 6, 6, 7, 8, 7, 8, 7, 8, 7, 8, 7, 8, 7, 8, 7, 8, 7, 8, 7, 8, 7, 8, 7, 8, 7, 8, 7, 8, 7, 8, 7, 8,
            9, 10, 9, 10, 9, 10, 6, 6, 6, 6, 6, 5, 2, 2, 2, 2, 3, 2, 9, 10, 9, 10, 9, 10, 6, 6, 6, 6, 6, 6, 9, 10, 9, 10, 9, 10, 9, 10, 9, 10, 9, 10, 9, 10, 9, 10, 9, 10, 9, 10, 9, 10, 9, 10, 9, 10, 9, 10, 9, 10,
            7, 8, 7, 8, 7, 8, 7, 8, 6, 6, 6, 5, 2, 2, 2, 2, 2, 2, 7, 8, 7, 8, 7, 8, 6, 5, 5, 5, 7, 8, 7, 8, 7, 8, 7, 8, 7, 8, 7, 8, 7, 8, 7, 8, 7, 8, 7, 8, 7, 8, 7, 8, 7, 8, 7, 8, 7, 8, 7, 8,
            9, 10, 9, 10, 9, 10, 9, 10, 6, 6, 6, 5, 2, 2, 2, 2, 2, 2, 9, 10, 9, 10, 9, 10, 5, 2, 2, 2, 9, 10, 9, 10, 9, 10, 9, 10, 9, 10, 9, 10, 9, 10, 9, 10, 9, 10, 9, 10, 9, 10, 9, 10, 9, 10, 9, 10, 9, 10, 9, 10,
            7, 8, 7, 8, 7, 8, 7, 8, 5, 5, 5, 2, 2, 2, 2, 2, 2, 3, 7, 8, 7, 8, 7, 8, 7, 8, 2, 2, 7, 8, 7, 8, 7, 8, 7, 8, 7, 8, 7, 8, 2, 2, 2, 2, 2, 2, 2, 2, 2, 2, 2, 2, 2, 2, 2, 2, 2, 2, 2, 28,
            9, 10, 9, 10, 9, 10, 9, 10, 2, 2, 4, 4, 4, 4, 4, 4, 2, 2, 9, 10, 9, 10, 9, 10, 9, 10, 2, 2, 9, 10, 9, 10, 9, 10, 9, 10, 9, 10, 9, 10, 2, 2, 2, 2, 2, 2, 2, 2, 11, 12, 22, 23, 2, 2, 2, 2, 2, 2, 2, 28,
            7, 8, 7, 8, 7, 8, 7, 8, 2, 2, 4, 20, 20, 20, 20, 2, 2, 2, 7, 8, 7, 8, 7, 8, 7, 8, 2, 2, 7, 8, 7, 8, 7, 8, 7, 8, 7, 8, 7, 8, 2, 2, 2, 2, 2, 2, 2, 2, 14, 24, 25, 16, 2, 2, 2, 2, 2, 2, 2, 28,
            9, 10, 9, 10, 9, 10, 9, 10, 2, 2, 4, 20, 20, 20, 20, 2, 2, 2, 9, 10, 9, 10, 9, 10, 9, 10, 6, 6, 9, 10, 9, 10, 9, 10, 9, 10, 9, 10, 9, 10, 2, 2, 2, 2, 2, 2, 2, 2, 17, 26, 27, 19, 2, 2, 2, 2, 2, 2, 2, 28,
            7, 8, 7, 8, 7, 8, 7, 8, 7, 8, 7, 8, 20, 20, 7, 8, 7, 8, 7, 8, 7, 8, 7, 8, 6, 6, 6, 6, 7, 8, 7, 8, 2, 2, 2, 28, 7, 8, 7, 8, 2, 2, 2, 2, 2, 2, 2, 2, 2, 2, 2, 2, 2, 2, 2, 11, 12, 13, 2, 28,
            9, 10, 9, 10, 9, 10, 9, 10, 9, 10, 9, 10, 20, 20, 9, 10, 9, 10, 9, 10, 9, 10, 9, 10, 6, 6, 6, 6, 9, 10, 9, 10, 2, 2, 2, 2, 9, 10, 9, 10, 2, 2, 11, 12, 22, 23, 2, 2, 2, 2, 2, 2, 2, 2, 2, 14, 15, 16, 2, 28,
            7, 8, 7, 8, 11, 12, 13, 2, 2, 2, 2, 4, 20, 20, 7, 8, 7, 8, 7, 8, 7, 8, 7, 8, 2, 3, 6, 6, 7, 8, 7, 8, 2, 2, 2, 2, 7, 8, 7, 8, 2, 2, 14, 24, 25, 16, 2, 2, 2, 2, 2, 2, 2, 2, 2, 17, 18, 19, 2, 28,
            9, 10, 9, 10, 14, 15, 16, 2, 2, 2, 2, 4, 20, 20, 9, 10, 9, 10, 9, 10, 9, 10, 9, 10, 2, 2, 2, 2, 9, 10, 9, 10, 2, 2, 28, 2, 9, 10, 9, 10, 2, 2, 17, 26, 27, 19, 2, 2, 2, 2, 2, 2, 2, 2, 2, 2, 2, 2, 2, 28,
            7, 8, 7, 8, 17, 18, 19, 2, 2, 2, 2, 4, 7, 8, 7, 8, 7, 8, 6, 6, 5, 2, 2, 28, 2, 2, 4, 2, 7, 8, 7, 8, 2, 7, 8, 2, 2, 5, 2, 2, 2, 2, 2, 2, 2, 2, 2, 2, 2, 2, 2, 2, 2, 2, 2, 2, 2, 2, 2, 28,
            9, 10, 9, 10, 15, 15, 2, 2, 2, 2, 2, 4, 9, 10, 9, 10, 9, 10, 6, 6, 6, 5, 2, 2, 3, 2, 2, 2, 9, 10, 9, 10, 2, 9, 10, 2, 2, 2, 2, 2, 2, 2, 2, 2, 2, 2, 2, 2, 2, 2, 2, 2, 2, 2, 2, 2, 2, 2, 2, 28,
            7, 8, 7, 8, 7, 8, 7, 8, 7, 8, 7, 8, 7, 8, 2, 5, 6, 6, 6, 6, 6, 5, 3, 2, 2, 2, 2, 2, 7, 8, 7, 8, 2, 2, 2, 2, 2, 2, 2, 2, 2, 2, 2, 2, 2, 2, 2, 2, 2, 2, 2, 2, 2, 2, 2, 2, 2, 2, 2, 28,
            9, 10, 9, 10, 9, 10, 9, 10, 9, 10, 9, 10, 9, 10, 4, 2, 5, 6, 6, 6, 5, 2, 2, 2, 2, 2, 3, 2, 9, 10, 9, 10, 5, 2, 2, 2, 7, 8, 7, 8, 2, 2, 2, 2, 2, 2, 2, 2, 2, 2, 2, 11, 12, 13, 11, 12, 13, 2, 2, 28,
            7, 8, 7, 8, 7, 8, 7, 8, 7, 8, 7, 8, 7, 8, 4, 2, 2, 5, 5, 5, 2, 2, 2, 2, 2, 2, 7, 8, 7, 8, 7, 8, 2, 2, 2, 2, 9, 10, 9, 10, 2, 2, 2, 2, 2, 11, 12, 13, 2, 2, 2, 14, 15, 16, 14, 15, 16, 2, 2, 28,
            9, 10, 9, 10, 9, 10, 9, 10, 9, 10, 9, 10, 9, 10, 4, 2, 2, 2, 2, 2, 2, 2, 2, 2, 2, 2, 9, 10, 9, 10, 9, 10, 2, 2, 2, 2, 7, 8, 7, 8, 2, 2, 2, 2, 2, 14, 15, 16, 2, 2, 2, 17, 18, 19, 17, 18, 19, 2, 2, 28,
            7, 8, 28, 2, 2, 2, 7, 8, 7, 8, 7, 8, 7, 8, 4, 2, 2, 2, 2, 2, 2, 2, 2, 3, 2, 2, 7, 8, 7, 8, 7, 8, 2, 2, 2, 3, 9, 10, 9, 10, 2, 2, 2, 2, 2, 17, 18, 19, 2, 2, 2, 2, 2, 2, 2, 2, 2, 2, 2, 28,
            9, 10, 2, 2, 2, 6, 9, 10, 9, 10, 9, 10, 9, 10, 2, 2, 2, 2, 2, 2, 2, 2, 2, 2, 2, 28, 9, 10, 9, 10, 9, 10, 6, 28, 2, 2, 7, 8, 7, 8, 2, 2, 2, 2, 2, 2, 2, 2, 2, 2, 2, 2, 2, 2, 2, 2, 2, 2, 2, 28,
            7, 8, 2, 6, 6, 6, 7, 8, 7, 8, 7, 8, 7, 8, 7, 8, 3, 3, 3, 3, 3, 3, 7, 8, 7, 8, 7, 8, 7, 8, 6, 6, 6, 28, 2, 2, 9, 10, 9, 10, 7, 8, 7, 8, 7, 8, 7, 8, 7, 8, 7, 8, 2, 2, 2, 7, 8, 7, 8, 7,
            9, 10, 6, 6, 6, 6, 9, 10, 9, 10, 9, 10, 9, 10, 9, 10, 5, 5, 5, 5, 5, 5, 9, 10, 9, 10, 9, 10, 9, 10, 6, 6, 6, 28, 5, 2, 2, 2, 7, 8, 9, 10, 9, 10, 9, 10, 9, 10, 9, 10, 9, 10, 2, 2, 2, 9, 10, 9, 10, 9,
            7, 8, 6, 6, 6, 2, 2, 2, 2, 28, 7, 8, 2, 2, 2, 2, 2, 2, 2, 2, 2, 2, 2, 2, 2, 2, 7, 8, 7, 8, 6, 6, 6, 2, 2, 2, 2, 2, 9, 10, 7, 8, 7, 8, 7, 8, 7, 8, 7, 8, 7, 8, 2, 2, 2, 7, 8, 7, 8, 7,
            9, 10, 28, 7, 8, 2, 2, 2, 2, 2, 9, 10, 4, 2, 2, 2, 2, 2, 2, 2, 2, 2, 2, 2, 6, 2, 9, 10, 9, 10, 6, 6, 2, 2, 2, 2, 2, 2, 2, 2, 9, 10, 9, 10, 9, 10, 9, 10, 9, 10, 9, 10, 2, 2, 2, 9, 10, 9, 10, 9,
            7, 8, 2, 9, 10, 2, 2, 2, 2, 2, 2, 4, 2, 4, 2, 2, 2, 3, 2, 2, 2, 2, 2, 5, 6, 6, 6, 2, 2, 3, 2, 2, 2, 2, 2, 2, 2, 2, 3, 2, 2, 2, 2, 2, 2, 2, 7, 8, 7, 8, 7, 8, 2, 2, 2, 2, 7, 8, 7, 8,
            9, 10, 2, 2, 2, 2, 2, 2, 2, 2, 2, 2, 4, 2, 4, 2, 2, 2, 2, 2, 5, 2, 2, 2, 6, 6, 6, 6, 5, 2, 2, 2, 2, 2, 2, 2, 2, 2, 2, 2, 3, 2, 2, 2, 2, 2, 9, 10, 9, 10, 9, 10, 2, 2, 2, 2, 9, 10, 9, 10,
            7, 8, 2, 2, 2, 2, 2, 2, 6, 6, 6, 2, 7, 8, 7, 8, 2, 2, 2, 2, 2, 2, 2, 6, 6, 6, 6, 6, 6, 2, 2, 2, 2, 2, 2, 2, 4, 7, 8, 7, 8, 2, 2, 2, 5, 2, 7, 8, 7, 8, 2, 2, 2, 2, 2, 2, 2, 2, 7, 8,
            9, 10, 2, 2, 2, 2, 6, 6, 6, 6, 6, 6, 9, 10, 9, 10, 7, 8, 7, 8, 7, 8, 7, 8, 6, 6, 6, 6, 6, 5, 2, 2, 2, 2, 28, 4, 28, 9, 10, 9, 10, 2, 2, 2, 2, 2, 9, 10, 9, 10, 2, 2, 2, 2, 2, 2, 2, 2, 9, 10,
            7, 8, 2, 2, 2, 6, 6, 6, 6, 6, 7, 8, 7, 8, 7, 8, 9, 10, 9, 10, 9, 10, 9, 10, 9, 10, 9, 10, 6, 2, 2, 2, 2, 2, 2, 2, 2, 7, 8, 7, 8, 7, 8, 20, 20, 20, 7, 8, 7, 8, 2, 2, 2, 2, 2, 2, 2, 2, 7, 8,
            9, 10, 9, 10, 9, 10, 9, 10, 9, 10, 9, 10, 9, 10, 9, 10, 7, 8, 7, 8, 7, 8, 7, 8, 7, 8, 7, 8, 7, 8, 7, 8, 7, 8, 7, 8, 7, 9, 10, 9, 10, 9, 10, 20, 20, 20, 9, 10, 9, 10, 2, 2, 2, 2, 2, 2, 2, 2, 9, 10,
            7, 8, 7, 8, 7, 8, 7, 8, 7, 8, 7, 8, 7, 8, 7, 8, 9, 10, 9, 10, 9, 10, 9, 10, 9, 10, 9, 10, 9, 10, 9, 10, 9, 10, 9, 10, 9, 10, 7, 8, 7, 8, 7, 8, 7, 8, 7, 8, 7, 8, 2, 2, 2, 2, 2, 2, 2, 2, 7, 8,
            9, 10, 9, 10, 9, 10, 9, 10, 9, 10, 9, 10, 9, 10, 9, 10, 7, 8, 7, 8, 7, 8, 7, 8, 7, 8, 7, 8, 7, 8, 7, 8, 7, 8, 7, 8, 7, 8, 9, 10, 9, 10, 9, 10, 9, 10, 9, 10, 9, 10, 28, 28, 28, 28, 28, 28, 28, 28, 9, 10],
	"width": 60,
	"npcs":
		[
			["door", 12, 9, "testtownroom1", 2],
			["nocreaturesgoback", 13, 19],
			["door", 17, 14, "testtownlabroom", 1],
			["door", 18, 14, "testtownlabroom", 2],
            ["door", 23, 7, "testtownroom2", 1],
            ["wanderingperson", "guy", 10, 15, 2, "Have you seen those weird bugs down south?"],
			["trainer", "first trainer", 15, 30, 2, "trainertest", "So you have a KENEMON too? Let's see who's stronger.", "I guess you were stronger...", 1],
            ["trainer", "second trainer", 25, 39, 1, "trainer2", "I caught this huge BOMBEETL in my hands! Wanna check it out?", "Nice. I still prefer BOMBEETL, though.", 2],
            ["founditem", 23, 4, "Poutine", 1],
            ["founditem", 15, 43, "Poutine", 2],
            ["founditem", 3, 53, "Poutine", 3],
            ["founditem", 37, 57, "Poutine", 4],
            ["founditem", 16, 21, "Capture Cube", 5],
            ["trainer", "third trainer", 36, 53, 2, "trainer3", "I've been using Capture Cubes to get all sorts of Kenemon.", "You fought well!", 3],
            ["trainer", "fourth trainer", 39, 50, 1, "trainer4", "Did you know that some Kenemon are more resistant to certain Types?", "My Fritzle resists so many attacks!", 4],
            ["trainer", "fifth trainer", 33, 37, 2, "trainer5", "Did you get a letter about Kenemon too?", "Wow! I guess you've been studying up.", 5]
		],
	"translocs":
		[
			[14, 12, 2],
			[12, 10, 2],
            [17, 15, 2],
            [18, 15, 2],
            [23, 8, 2]
		],
	"encountertable":
		[
			["Palpillar", [4, 6], 5],
			["Bombeetl", [4, 6], 5],
			["Achewig", [4, 6], 2]
		],
	"encounterchance": 5,
    "background": "white",
    "dividers":
    [
        ["Colus Town", 1, 1, 29, 18],
        ["Route 1", 1, 20, 29, 27],
        ["Route 1", 13, 48, 16, 3],
        ["Route 2", 12, 58, 12, 12],
        ["Route 2", 48, 60, 36, 10],
        ["Route 2", 40, 50, 10, 18],
        ["Tetra City", 60, 50, 20, 20]
    ]
}