{
	"tiles": "outdoors",
	"data": 
		[
			4,5,4,5,4,5,4,5,4,5,4,5,3,3,3,3,4,5,4,5,4,5,4,5,
			6,7,6,7,6,7,6,7,6,7,6,7,3,3,3,3,6,7,6,7,6,7,6,7,
			5,2,2,2,2,2,2,2,2,2,2,2,3,3,3,3,2,2,2,2,2,2,2,4,
			7,2,2,2,2,2,2,2,2,2,2,2,3,3,3,3,2,2,2,2,2,2,2,6,
			5,2,2,2,2,2,2,2,2,2,2,2,2,2,2,2,2,2,2,2,2,2,2,4,
			7,2,2,2,2,2,2,2,4,5,2,2,2,2,2,2,2,2,2,2,2,2,2,6,
			5,2,2,2,2,2,2,2,6,7,2,2,2,2,2,2,2,2,2,2,2,2,2,4,
			7,2,2,2,2,2,2,2,2,2,2,2,2,2,2,2,2,2,2,2,2,2,2,6,
			5,2,2,2,2,2,2,2,2,2,2,2,2,2,2,2,2,2,2,2,2,2,2,4,
			7,2,2,2,2,2,2,2,2,2,2,2,2,2,2,2,2,2,2,2,2,2,2,6,
			5,2,2,2,2,2,2,2,2,2,2,2,2,2,2,2,2,2,4,5,2,2,2,4,
			7,2,2,2,2,2,2,2,2,2,2,2,2,2,2,2,2,2,6,7,2,2,2,6,
			5,2,2,2,2,2,2,2,2,2,2,2,2,2,2,2,2,2,2,2,2,2,2,4,
			7,2,2,2,2,2,2,2,2,2,2,2,2,2,2,2,2,2,2,2,2,2,2,6,
			5,2,2,2,2,2,2,2,2,2,2,2,2,2,2,2,2,2,2,2,2,2,2,4,
			7,4,5,4,5,4,5,4,5,4,5,4,5,4,5,4,5,4,5,4,5,4,5,6
		],
	"width": 24,
	"npcs":
		[
			["signpost", 7, 5, "Hello there"]
		],
	"translocs":
		[
			[6, 11, 2]
		],
	"encountertable":
		[
			["Palpillar", [3, 5], 5],
			["Bombeetl", [3, 5], 5],
			["Achewig", [4, 6], 1]
		]
}