{
"tiles": "indoors",
         "data":[4, 4, 4, 4, 4, 4, 4, 4,
            2, 2, 2, 2, 2, 2, 2, 2,
            2, 2, 7, 9, 9, 8, 2, 2,
            2, 2, 2, 2, 2, 2, 2, 2,
            2, 2, 2, 2, 2, 2, 2, 2,
            2, 2, 2, 2, 2, 2, 2, 2,
            2, 2, 2, 2, 2, 2, 2, 2,
            2, 2, 2, 2, 2, 2, 2, 2,
            2, 2, 2, 2, 2, 2, 2, 2,
            2, 2, 2, 2, 2, 2, 2, 2,
            2, 2, 2, 2, 2, 2, 2, 2,
            2, 2, 2, 2, 2, 2, 2, 2,
            2, 2, 2, 3, 3, 2, 2, 2,
            5, 5, 5, 6, 6, 5, 5, 5],
"width": 8,
"npcs":
	[
		["tablecube", 4, 3],
      ["door", 4, 14, "testtown", 3],
      ["door", 5, 14, "testtown", 4]
	],
"translocs":
	[
		[4, 13, 0],
      [5, 13, 0]
	],
	"background": "black"
}