{
	"tiles": "outdoors",
	"data": 
		[
8,9,10,9,10,9,10,9,10,9,10,9,10,9,10,9,10,9,10,9,10,9,10,9,
10,4,4,4,4,4,4,4,4,4,4,4,4,4,4,4,4,4,4,4,4,4,4,7,
8,4,4,4,4,4,4,4,4,4,4,4,4,4,2,2,2,2,2,2,3,2,4,9,
10,4,4,2,5,2,2,2,2,2,2,3,2,2,2,2,11,12,13,2,2,2,4,7,
8,4,4,2,2,2,2,2,2,7,8,2,2,2,2,2,14,15,16,2,2,2,4,9,
10,4,4,2,2,11,12,13,2,9,10,2,2,3,2,2,17,18,19,2,2,2,4,7,
8,4,4,3,2,14,15,16,2,2,2,2,2,2,2,2,2,2,2,2,3,2,4,9,
10,4,4,2,2,17,18,19,2,2,2,5,2,2,2,2,2,2,2,2,2,4,4,7,
8,4,4,2,3,2,2,2,2,3,2,2,2,2,2,3,2,5,5,5,5,4,4,9,
10,4,4,2,2,2,2,2,2,2,2,2,2,2,2,2,2,5,5,5,5,4,4,7,
8,4,4,5,5,5,2,2,2,2,11,12,12,13,2,2,2,5,5,5,5,4,4,9,
10,4,4,5,5,5,2,5,2,2,14,15,15,16,2,2,2,2,2,2,2,4,4,7,
8,4,2,5,5,5,2,2,2,2,17,18,18,19,2,2,3,2,2,2,3,2,4,9,
10,4,2,5,5,5,5,2,2,2,2,2,2,2,2,2,2,2,2,2,2,2,4,7,
8,4,2,5,5,5,5,2,3,2,2,2,2,2,2,5,5,2,2,2,2,2,4,9,
10,4,2,2,5,5,5,2,2,2,2,2,2,2,2,5,5,2,2,2,2,2,2,7,
8,2,2,2,2,2,2,2,2,2,2,2,2,2,2,2,2,2,2,2,2,2,2,7,
10,7,8,7,8,7,8,6,6,6,6,6,6,7,8,7,8,7,8,7,8,7,8,9,
8,9,10,9,10,9,10,6,6,6,6,6,6,9,10,9,10,9,10,9,10,9,10,7,
10,7,8,7,8,7,8,6,6,6,6,6,6,7,8,7,8,7,8,7,8,7,8,9
		],
	"width": 24,
	"npcs":
		[
			["signpost", 7, 5, "Hello there"]
		],
	"translocs":
		[
			[6, 11, 2]
		],
	"encountertable":
		[
			["Palpillar", [4, 6], 5],
			["Bombeetl", [4, 6], 5],
			["Achewig", [4, 6], 2]
		],
	"encounterchance": 7
}