{
	"tiles": "outdoors",
"data":[7, 8, 7, 8, 7, 8, 7, 8, 7, 8, 7, 8, 7, 8, 7, 8, 7, 8, 7, 8, 7, 8, 7, 8, 7, 8, 7, 8, 7, 8, 7, 8, 7, 8,
            9, 10, 9, 10, 9, 10, 9, 10, 9, 10, 9, 10, 9, 10, 9, 10, 9, 10, 9, 10, 9, 10, 9, 10, 9, 10, 9, 10, 9, 10, 9, 10, 9, 10,
            7, 8, 7, 8, 7, 8, 4, 4, 4, 4, 4, 4, 4, 4, 4, 4, 4, 4, 4, 4, 4, 4, 4, 4, 4, 4, 4, 4, 7, 8, 7, 8, 7, 8,
            9, 10, 9, 10, 9, 10, 4, 4, 4, 4, 4, 4, 4, 4, 4, 4, 4, 4, 4, 2, 2, 2, 2, 2, 2, 3, 2, 4, 9, 10, 9, 10, 9, 10,
            7, 8, 7, 8, 7, 8, 4, 4, 2, 5, 2, 2, 2, 2, 2, 2, 3, 2, 2, 2, 2, 11, 12, 13, 2, 2, 2, 4, 7, 8, 7, 8, 7, 8,
            9, 10, 9, 10, 9, 10, 4, 4, 2, 2, 2, 2, 2, 2, 7, 8, 2, 2, 2, 2, 2, 14, 15, 16, 2, 2, 2, 4, 9, 10, 9, 10, 9, 10,
            7, 8, 7, 8, 7, 8, 4, 4, 2, 2, 11, 12, 13, 2, 9, 10, 2, 2, 3, 2, 2, 17, 18, 19, 2, 2, 2, 4, 7, 8, 7, 8, 7, 8,
            9, 10, 9, 10, 9, 10, 4, 4, 3, 2, 14, 15, 16, 2, 2, 2, 2, 2, 2, 2, 2, 2, 2, 2, 2, 3, 2, 4, 9, 10, 9, 10, 9, 10,
            7, 8, 7, 8, 7, 8, 4, 4, 2, 2, 17, 18, 19, 2, 2, 2, 5, 2, 2, 2, 2, 2, 2, 2, 2, 2, 4, 4, 7, 8, 7, 8, 7, 8,
            9, 10, 9, 10, 9, 10, 4, 4, 2, 3, 2, 2, 2, 2, 3, 2, 2, 2, 2, 2, 3, 2, 5, 5, 5, 5, 4, 4, 9, 10, 9, 10, 9, 10,
            7, 8, 7, 8, 7, 8, 4, 4, 2, 2, 2, 2, 2, 2, 2, 2, 2, 2, 2, 2, 2, 2, 5, 5, 5, 5, 4, 4, 7, 8, 7, 8, 7, 8,
            9, 10, 9, 10, 9, 10, 4, 4, 5, 5, 5, 2, 2, 2, 2, 11, 12, 12, 13, 2, 2, 2, 5, 5, 5, 4, 4, 4, 9, 10, 9, 10, 9, 10,
            7, 8, 7, 8, 7, 8, 4, 4, 5, 5, 5, 2, 5, 2, 2, 14, 15, 15, 16, 2, 2, 2, 2, 2, 2, 20, 20, 20, 20, 20, 20, 20, 20, 20,
            9, 10, 9, 10, 9, 10, 4, 2, 5, 5, 5, 2, 2, 2, 2, 17, 18, 21, 19, 2, 2, 3, 2, 2, 2, 20, 20, 20, 20, 20, 20, 20, 20, 20,
            7, 8, 7, 8, 7, 8, 4, 2, 5, 5, 5, 5, 2, 2, 2, 2, 2, 2, 2, 2, 2, 2, 2, 2, 2, 20, 20, 20, 20, 20, 20, 20, 20, 20,
            9, 10, 9, 10, 9, 10, 4, 2, 5, 5, 5, 5, 2, 3, 2, 2, 2, 2, 2, 2, 5, 5, 2, 2, 3, 20, 20, 20, 20, 20, 20, 20, 20, 20,
            7, 8, 7, 8, 7, 8, 4, 2, 2, 5, 5, 5, 2, 2, 2, 2, 2, 2, 2, 2, 5, 5, 2, 2, 3, 3, 4, 4, 7, 8, 7, 8, 7, 8,
            9, 10, 9, 10, 9, 10, 2, 2, 2, 2, 2, 2, 2, 2, 2, 2, 2, 2, 2, 2, 2, 2, 2, 2, 2, 2, 4, 4, 9, 10, 9, 10, 9, 10,
            7, 8, 7, 8, 7, 8, 7, 8, 7, 8, 7, 8, 5, 5, 5, 5, 7, 8, 7, 8, 7, 8, 7, 8, 7, 8, 7, 8, 7, 8, 7, 8, 7, 8,
            9, 10, 9, 10, 9, 10, 9, 10, 9, 10, 9, 10, 5, 5, 5, 5, 9, 10, 9, 10, 9, 10, 9, 10, 9, 10, 9, 10, 9, 10, 9, 10, 9, 10,
            7, 8, 7, 8, 7, 8, 7, 8, 7, 8, 2, 2, 5, 5, 5, 2, 7, 8, 7, 8, 7, 8, 7, 8, 7, 8, 7, 8, 7, 8, 7, 8, 7, 8,
            9, 10, 9, 10, 9, 10, 9, 10, 9, 10, 2, 2, 2, 2, 2, 2, 9, 10, 9, 10, 9, 10, 9, 10, 9, 10, 9, 10, 9, 10, 9, 10, 9, 10,
            7, 8, 7, 8, 7, 8, 7, 8, 2, 2, 2, 3, 2, 2, 2, 2, 7, 8, 7, 8, 7, 8, 7, 8, 7, 8, 7, 8, 7, 8, 7, 8, 7, 8,
            9, 10, 9, 10, 9, 10, 9, 10, 2, 2, 2, 2, 2, 2, 7, 8, 9, 10, 9, 10, 9, 10, 9, 10, 9, 10, 9, 10, 9, 10, 9, 10, 9, 10,
            7, 8, 7, 8, 7, 8, 7, 8, 7, 8, 2, 2, 2, 3, 9, 10, 2, 2, 2, 2, 4, 2, 2, 2, 3, 2, 5, 2, 7, 8, 7, 8, 7, 8,
            9, 10, 9, 10, 9, 10, 9, 10, 9, 10, 2, 2, 2, 2, 7, 8, 2, 2, 4, 2, 2, 2, 4, 2, 2, 5, 6, 5, 9, 10, 9, 10, 9, 10,
            7, 8, 7, 8, 7, 8, 7, 8, 6, 6, 5, 2, 2, 2, 9, 10, 2, 2, 7, 8, 7, 8, 7, 8, 5, 5, 6, 6, 7, 8, 7, 8, 7, 8,
            9, 10, 9, 10, 9, 10, 9, 10, 6, 6, 5, 2, 2, 7, 8, 2, 2, 2, 9, 10, 9, 10, 9, 10, 5, 6, 6, 6, 9, 10, 9, 10, 9, 10,
            7, 8, 7, 8, 7, 8, 6, 6, 6, 6, 5, 2, 2, 9, 10, 2, 2, 2, 7, 8, 7, 8, 7, 8, 6, 6, 6, 6, 6, 6, 7, 8, 7, 8,
            9, 10, 9, 10, 9, 10, 6, 6, 6, 6, 6, 5, 2, 2, 2, 2, 3, 2, 9, 10, 9, 10, 9, 10, 6, 6, 6, 6, 6, 6, 9, 10, 9, 10,
            7, 8, 7, 8, 7, 8, 7, 8, 6, 6, 6, 5, 2, 2, 2, 2, 2, 2, 7, 8, 7, 8, 7, 8, 6, 5, 5, 5, 7, 8, 7, 8, 7, 8,
            9, 10, 9, 10, 9, 10, 9, 10, 6, 6, 6, 5, 2, 2, 2, 2, 2, 2, 9, 10, 9, 10, 9, 10, 5, 2, 2, 2, 9, 10, 9, 10, 9, 10,
            7, 8, 7, 8, 7, 8, 7, 8, 5, 5, 5, 2, 2, 2, 2, 2, 2, 2, 7, 8, 7, 8, 7, 8, 7, 8, 2, 2, 7, 8, 7, 8, 7, 8,
            9, 10, 9, 10, 9, 10, 9, 10, 2, 2, 4, 4, 4, 4, 4, 4, 2, 2, 9, 10, 9, 10, 9, 10, 9, 10, 2, 2, 9, 10, 9, 10, 9, 10,
            7, 8, 7, 8, 7, 8, 7, 8, 2, 2, 4, 20, 20, 20, 20, 4, 2, 2, 7, 8, 7, 8, 7, 8, 7, 8, 2, 2, 7, 8, 7, 8, 7, 8,
            9, 10, 9, 10, 9, 10, 9, 10, 2, 2, 4, 20, 20, 20, 20, 4, 2, 2, 9, 10, 9, 10, 9, 10, 9, 10, 2, 2, 9, 10, 9, 10, 9, 10,
            7, 8, 7, 8, 7, 8, 7, 8, 7, 8, 7, 8, 20, 20, 20, 7, 8, 7, 8, 7, 8, 7, 8, 7, 8, 2, 2, 3, 7, 8, 7, 8, 7, 8,
            9, 10, 9, 10, 9, 10, 9, 10, 9, 10, 9, 10, 20, 20, 20, 9, 10, 9, 10, 9, 10, 9, 10, 9, 10, 2, 2, 2, 9, 10, 9, 10, 9, 10,
            7, 8, 7, 8, 11, 12, 13, 2, 2, 2, 2, 4, 20, 20, 20, 7, 8, 7, 8, 7, 8, 7, 8, 7, 8, 3, 2, 2, 7, 8, 7, 8, 7, 8,
            9, 10, 9, 10, 14, 15, 16, 2, 2, 2, 2, 4, 20, 20, 20, 9, 10, 9, 10, 9, 10, 9, 10, 9, 10, 2, 2, 2, 9, 10, 9, 10, 9, 10,
            7, 8, 7, 8, 17, 18, 19, 2, 2, 2, 2, 4, 7, 8, 7, 8, 7, 8, 6, 6, 5, 2, 2, 2, 2, 2, 4, 2, 7, 8, 7, 8, 7, 8,
            9, 10, 9, 10, 15, 15, 2, 2, 2, 2, 2, 4, 9, 10, 9, 10, 9, 10, 6, 6, 6, 5, 2, 2, 3, 2, 2, 2, 9, 10, 9, 10, 9, 10,
            7, 8, 7, 8, 7, 8, 7, 8, 7, 8, 7, 8, 7, 8, 2, 5, 6, 6, 6, 6, 6, 5, 3, 2, 2, 2, 2, 2, 7, 8, 7, 8, 7, 8,
            9, 10, 9, 10, 9, 10, 9, 10, 9, 10, 9, 10, 9, 10, 4, 2, 5, 6, 6, 6, 5, 2, 2, 2, 2, 2, 3, 2, 9, 10, 9, 10, 9, 10,
            7, 8, 7, 8, 7, 8, 7, 8, 7, 8, 7, 8, 7, 8, 4, 2, 2, 5, 5, 5, 2, 2, 2, 2, 2, 2, 7, 8, 7, 8, 7, 8, 7, 8,
            9, 10, 9, 10, 9, 10, 9, 10, 9, 10, 9, 10, 9, 10, 4, 2, 2, 2, 2, 2, 2, 2, 2, 2, 2, 2, 9, 10, 9, 10, 9, 10, 9, 10,
            7, 8, 7, 8, 7, 8, 7, 8, 7, 8, 7, 8, 7, 8, 4, 2, 2, 2, 2, 2, 2, 2, 2, 3, 2, 2, 7, 8, 7, 8, 7, 8, 7, 8,
            9, 10, 9, 10, 9, 10, 9, 10, 9, 10, 9, 10, 9, 10, 2, 2, 2, 2, 2, 2, 2, 2, 2, 2, 2, 2, 9, 10, 9, 10, 9, 10, 9, 10,
            7, 8, 7, 8, 7, 8, 7, 8, 7, 8, 7, 8, 7, 8, 7, 8, 2, 2, 2, 2, 2, 2, 7, 8, 7, 8, 7, 8, 7, 8, 7, 8, 7, 8,
            9, 10, 9, 10, 9, 10, 9, 10, 9, 10, 9, 10, 9, 10, 9, 10, 2, 2, 2, 2, 2, 2, 9, 10, 9, 10, 9, 10, 9, 10, 9, 10, 9, 10],
	"width": 34,
	"npcs":
		[
			["door", 12, 9, "testtownroom1", 1]
		],
	"translocs":
		[
			[12, 10, 2],
			[12, 10, 2]
		],
	"encountertable":
		[
			["Palpillar", [4, 6], 5],
			["Bombeetl", [4, 6], 5],
			["Achewig", [4, 6], 2]
		],
	"encounterchance": 7,
    "background": "white"
}