{
"tiles": "overworld",
"data": 
	[
		3,3,3,3,3,3,3,3,3,3,
		3,2,2,2,2,2,2,2,3,3,
		3,2,2,2,2,2,2,2,3,3,
		3,2,2,2,2,2,2,2,2,3,
		3,2,2,2,2,2,2,2,2,3,
		3,3,3,2,3,3,3,3,3,3
	],
"width": 10,
"npcs":
	[
		["door", 4, 6, "testtown", 1]
	],
"translocs":
	[
		[4, 5, 0]
	]
}